3333330000000003333
3333333000000033332
0202233000000033222
0202200000000003222
0020000000000003222
0020000000000000002
0020000000000000000
3220000000000000000
3330000000000000000
3333003000030000033
3333001300010000033
1111001100110000011
1111100000000000111
1111110000000000111