0000000000333330000
0000000003333333000
0000000003333333000
0033330000002200000
0033330000000200000
0000200000032200000
0002200003333333000
0011110011111111100
0011110011444441100
1011110011111111100
1000000000000000001
1000000000000000001
1000000000000000011
1100000000000000111