111111111111111111
000000000000000000
000001000000000000
000000000000000000
000000000000000000
000000000000000000
000001000000000000
000000000040000000
000000000000000000
000000000100000000
000000000000000000
000000000000000000
000000000000000000