3300000001000000000
3330000031000000003
3330000311000000003
2230000151000000033
2330000151000000003
2333000151000000033
2033010151000000333
2220010111000000032
2000010111000000002
2000010111000000000
2000033333300000000
3200022222220000003
2330000000000000003
1111000000000000011