000000000100000011
000000000111000011
000000000111000011
000000000111000011
000000000111100011
000000011111100011
000000011111100011
000000011111100011
300000011111100011
230000011111100032
220000011111100322
222000011100003222
222000000000022222