0044400400000000000
0011100100000000000
0015100100000000000
0015100100000000000
4015101100000000000
1015101100000000000
1015101100000000000
1011101100000000000
2011101100000000000
2221101100000000002
2222201100000000002
2222222100000000222
2222222220000002222
0000000000000022222