0000000004000000111
0000000001110000111
0000000001110000111
0000000001110000111
0000000001111000111
0000000111111000111
0000000115511000111
0000000111111000111
3000000151151000111
2000000111111000112
2200000111111000122
2200000111000003222
2220000000000022222