0111001100000001111
0141041100000001551
0151011100000001441
0141011100000001111
0111014100000001441
0141011100000001111
0151015100000001441
0111011100000001111
0111014100000001111
0111011100000001111
3311333300000001111
3333333300000003123
0000000000000033323
0000000000002222222
2200000000022222222